BreakMirror = "Break Mirror",
DisassembleWatch = "Disassemble Watch",
DismantleToolBox = "Dismantle Tool Box",
DismatleBulletproofVest = "Dismantle Bulletproof Vest",
ExtractSugarBerries = "Extract Sugar from Berries",
GrindCandies = "Grind Sugar from Candies",
ItemName_EssencialR.CharcoalPowder = "Charcoal Powder",
MakeAlcoholWipes = "Make Alcohol Wipes",
MakeAluminium = "Recycle Cans",
MakeAmmoStraps = "Make Ammo Straps",
MakeAnimalFeedBag = "Make Animal Feed Bag",
MakeBakingSoda = "Make Baking Soda",
MakeBlackPaint = "Make Black Paint",
MakeBluePaint = "Make Blue Paint",
MakeBrownPaint = "Make Brown Paint",
MakeCarBatteryCharger = "Make Car Battery Charger",
MakeCharcoalPowder = "Make Charcoal Powder",
MakeCleaningLiquid = "Make Cleaning Liquid",
MakeCyanPaint = "Make Cyan Paint",
MakeDisinfectant = "Make Disinfectant",
MakeElectricWire = "Make Electric Wire",
MakeEngineParts = "Make Spare Engine Parts",
MakeFiberglassTape = "Make Fiberglass Tape",
MakeFishingHook = "Make Fishing Hook",
MakeGenerator = "Make Generator",
MakeGeneratorPremium = "Make Generator Premium",
MakeGlue = "Make Glue",
MakeGrayPaint = "Make Gray Paint",
MakeGreenPaint = "Make Green Paint",
MakeGunLight = "Make Gun Light",
MakeHay = "Make Hay",
MakeJack = "Make Jack",
MakeLightBluePaint = "Make Light Blue Paint",
MakeLightBrownPaint = "Make Light Brown Paint",
MakeMatches = "Make Matches",
MakeMop = "Make Mop",
MakeMotionSensor = "Make Motion Sensor",
MakeNails = "Make Nails",
MakeNeedle = "Make Needle",
MakeNutsBolts = "Make Nuts and Bolts",
MakeOrangePaint = "Make Orange Paint",
MakePaper = "Make Paper",
MakePeanutButter = "Make Peanut Butter",
MakePinkPaint = "Make Pink Paint",
MakePurplePaint = "Make Purple Paint",
MakeRedPaint = "Make Red Paint",
MakeRollingPaper = "Make Rolling Paper",
MakeSalt = "Make Salt",
MakeScrews = "Make Screws",
MakeSledgehammer = "Make Sledgehammer",
MakeSugar = "Make Sugar",
MakeTarp = "Make Tarp",
MakeTritiumSights = "Make Tritium Sights",
MakeTurquoisePaint = "Make Turquoise Paint",
MakeUnusableMetal = "Make Unusable Metal",
MakeVinegar = "Make Vinegar",
MakeWeldingRods = "Make Welding Rods",
MakeWhetstone = "Make Whetstone",
MakeWhitePaint = "Make White Paint",
MakeWoodGlue = "Make Wood Glue using Unusable Wood",
MakeWoodGlueTwigs = "Make Wood Glue using Twigs",
MakeYeast = "Make Yeast from Berries",
Makex2Scope = "Make x2 Scope",
RecycleElectricWire = "Recycle Electrical Wires",
RipNotebook = "Rip Notebook",
RipSLeatherItem = "Rip Small Leather Item",
UI_CraftCat_Essential = "Essential",