3TileGreenGarageDoor = "3 Tile Green Garage Door",
3TileRedWindowGarageDoor = "3 Tile Red Window Garage Door",
3TileRollingGarageDoor = "3 Tile Rolling Garage Door",
3TileRollingWindowGarageDoor = "3 Tile Rolling Window Garage Door",
3TileWhiteGarageDoor = "3 Tile White Garage Door",
50sSeat = "50s Seat",
AntiqueOutdoorLamp = "Antique Outdoor Lamp",
AntiqueOven = "Antique Oven",
ArchedWhiteWoodenWindow = "Arched White Wooden Window",
AutumGrassFloor = "Autum Grass Floor",
BarBlackWallBar = "Bar Black Wall Bar",
BarBrownWallBar = "Bar Brown Wall Bar",
Barbecue = "Barbecue",
BathroomBrownRug = "Bathroom Brown Rug",
BathroomPurpleRug = "Bathroom Purple Rug",
BatteredCardboardBox = "Battered Cardboard Box",
BedroomDrawers = "Bedroom Drawers",
BeigeAsphaltCornerFloor = "Beige Asphalt Corner Floor",
BeigeAsphaltFloor = "Beige Asphalt Floor",
BeigeGravelCornerFloor = "Beige Gravel Corner Floor",
BeigeGravelEdgeFloor = "Beige Gravel Edge Floor",
BeigeGravelFloor = "Beige Gravel Floor",
BeigeSink = "Beige Sink",
BeigeSmoothTilesFloor = "Beige Smooth Tiles Floor",
BigCardboardBox = "Big Cardboard Box",
BigWallShelves = "Big Wall Shelves",
BigWallShelvesCorner = "Big Wall Shelves Corner",
BirchwoodCounter = "Birchwood Counter",
BirchwoodCounterCorner = "Birchwood Counter Corner",
BirchwoodFloatingCounter = "Birchwood Floating Counter",
BlackBarCounter = "Black Bar Counter",
BlackBarCounterCorner = "Black Bar Counter Corner",
BlackDoor = "Black Door",
BlackFancyArmchair = "Black Fancy Armchair",
BlackMetalDoor = "Black Metal Door",
BlackModernLowTable = "Black Modern Low Table",
BlackOfficeChair = "Black Office Chair",
BlackPanelDoor = "Black Panel Door",
BleachedLargeTable = "Bleached Large Table",
BlueBed = "Blue Bed",
BlueComboWasherDryer = "Blue Combo Washer/Dryer",
BlueComfyArmchair = "Blue Comfy Armchair",
BlueDoor = "Blue Door",
BlueDumpster = "Blue Dumpster",
BlueFridge = "Blue Fridge",
BlueMetalDoor = "Blue Metal Door",
BluePlasticChair = "Blue Plastic Chair",
BlueRattanArmchair = "Blue Rattan Armchair",
BlueRattanCouch = "Blue Rattan Couch",
BlueSeat = "Blue Seat",
BlueWallLocker = "Blue Wall Locker",
BordeauxRug = "Bordeaux Rug",
BordeauxRugCorner = "Bordeaux Rug Corner",
BordeauxSideRug = "Bordeaux Side Rug",
BordeauxVictorian1Rug = "Bordeaux Victorian 1 Rug",
BordeauxVictorian2Rug = "Bordeaux Victorian 2 Rug",
BrickWallBench = "Brick Wall Bench",
BroadWhiteLargeTable = "Broad White Large Table",
BrownBarCounter = "Brown Bar Counter",
BrownBarCounterCorner = "Brown Bar Counter Corner",
BrownDoor = "Brown Door",
BrownGlassSlidingDoor = "Brown Glass Sliding Door",
BrownLargeTable = "Brown Large Table",
BrownLazyArmchair = "Brown Lazy Armchair",
BrownLazyCouch = "Brown Lazy Couch",
BrownLowTable = "Brown Low Table",
BrownMetalStairs = "Brown Metal Stairs",
BrownOfficeLargeDesk = "Brown Office Large Desk",
BrownPanelDoor = "Brown Panel Door",
BrownWindowDoor = "Brown Door with Window",
BrownWoodenStairs = "Brown Wooden Stairs",
BunkBed = "Bunk Bed",
CarLiftLowerPart = "Car Lift Lower Part",
CarLiftMiddleMiddlePart = "Car Lift Middle Middle Part",
CarLiftPillar = "Car Lift Pillar",
CarLiftUpperMiddlePart = "Car Lift Upper Middle Part",
CeramicFloorAcaciaTiles = "Ceramic Acacia Floor Tiles",
CeramicFloorBeigeCheckeredTiles = "Ceramic Beige Checkered Floor Tiles",
CeramicFloorBirchwoodTiles = "Ceramic Birchwood Floor Tiles",
CeramicFloorBlackDiagonalTiles = "Ceramic Black Diagonal Floor Tiles",
CeramicFloorBlackTiles = "Ceramic Black Floor Tiles",
CeramicFloorBlueCheckeredTiles = "Ceramic Blue Checkered Floor Tiles",
CeramicFloorBrownCheckeredTiles = "Ceramic Brown Checkered Floor Tiles",
CeramicFloorBrownDiagonalTiles = "Ceramic Brown Diagonal Floor Tiles",
CeramicFloorBrownTiles = "Ceramic Brown Floor Tiles",
CeramicFloorCinnamonTiles = "Ceramic Cinnamon Floor Tiles",
CeramicFloorDarkGreySquaresTiles = "Ceramic Dark Grey Squares Floor Tiles",
CeramicFloorDarkGreyTiles = "Ceramic Dark Grey Floor Tiles",
CeramicFloorGreenDiagonalTiles = "Ceramic Green Diagonal Floor Tiles",
CeramicFloorGreenTiles = "Ceramic Green Floor Tiles",
CeramicFloorGreyCheckeredTiles = "Ceramic Grey Checkered Floor Tiles",
CeramicFloorGreyDiagonalTiles = "Ceramic Grey Diagonal Floor Tiles",
CeramicFloorGreySquaresTiles = "Ceramic Grey Squares Floor Tiles",
CeramicFloorGreyTiles = "Ceramic Grey Floor Tiles",
CeramicFloorHardwoodTiles = "Ceramic Hardwood Floor Tiles",
CeramicFloorPurpleTiles = "Ceramic Purple Floor Tiles",
CeramicFloorWhiteCheckeredTiles = "Ceramic White Checkered Floor Tiles",
CeramicFloorWhiteDiagonalTiles = "Ceramic White Diagonal Floor Tiles",
CeramicFloorYellowCheckeredTiles = "Ceramic Yellow Checkered Floor Tiles",
CeramicFloorYellowDiagonalTiles = "Ceramic Yellow Diagonal Floor Tiles",
ChainlinkAndRazorWireHighFence = "Chainlink And Razor Wire High Fence",
ChainlinkAndRazorWireHighFenceCorner = "Chainlink And Razor Wire High Fence Corner",
ChainlinkAndRazorWireHighFencePost = "Chainlink And Razor Wire High Fence Post",
CherryDoor = "Cherry Door",
ChromeMicrowave = "Chrome Microwave",
ChromeSink = "Chrome Sink",
ChromeWindow = "Chrome Window",
ChurchPew = "Church Pew",
ClothesStand = "Clothes Stand",
ConcreteCornerFloor = "Concrete Corner Floor",
ConcreteFloor = "Concrete Floor",
ConcreteRoadBlock = "Concrete Road Block",
ConcreteWheelStop = "Concrete Wheel Stop",
ContextMenu_LookAtBlueprints = "Look At Blueprints",
ContextMenu_StartSketchingBlueprints = "Start Sketching Blueprints",
ContextMenu_TooDarkToDraw = "Too dark to draw.",
DarkAsphaltCornerFloor = "Dark Asphalt Corner Floor",
DarkAsphaltEdgeFloor = "Dark Asphalt Edge Floor",
DarkAsphaltFloor = "Dark Asphalt Floor",
DarkBrownWoodenStairs = "Dark Brown Wooden Stairs",
DarkCounter = "Dark Counter",
DarkCounterCorner = "Dark Counter Corner",
DarkGreenRug = "Dark Green Rug",
DarkGreenRugCorner = "Dark Green Rug Corner",
DarkGreenSideRug = "Dark Green Side Rug",
DarkGreenVictorian1Rug = "Dark Green Victorian 1 Rug",
DarkGreenVictorian2Rug = "Dark Green Victorian 2 Rug",
DarkGreyRug = "Dark Grey Rug",
DarkGreySideRug = "Dark Grey Side Rug",
DarkGreySmoothTilesFloor = "Dark Grey Smooth Tiles Floor",
DarkIndustrialSink = "Dark Industrial Sink",
DarkLargeTable = "Dark Large Table",
DarkOakLargeTable = "Dark Oak Large Table",
DarkPurpleRug = "Dark Purple Rug",
DarkPurpleRugCorner = "Dark Purple Rug Corner",
DarkPurpleSideRug = "Dark Purple Side Rug",
DarkPurpleVictorian1Rug = "Dark Purple Victorian 1 Rug",
DarkPurpleVictorian2Rug = "Dark Purple Victorian 2 Rug",
DarkWoodenChair = "Dark Wooden Chair",
DarkWoodenLargeTable = "Dark Wooden Large Table",
DeluxeShower = "Deluxe Shower",
DinerCounter = "Diner Counter",
DinerCounterCorner = "Diner Counter Corner",
DoorMat = "Door Mat",
DoubleMetalBlackGlassLeftDoor = "Double Metal Black Glass Left Door",
DoubleMetalBlackGlassRightDoor = "Double Metal Black Glass Right Door",
DoubleMetalGreyLeftDoor = "Double Metal Grey Left Door",
DoubleMetalGreyRightDoor = "Double Metal Grey Right Door",
DoubleMetalOrangeKitchenGlassLeftDoor = "Double Metal Orange Kitchen Glass Left Door",
DoubleMetalOrangeKitchenGlassRightDoor = "Double Metal Orange Kitchen Glass Right Door",
DoublePaneBlackDoor = "Double Pane Black Door",
ElevatorStairs = "Elevator Stairs",
FadedGrassFloor = "Faded Grass Floor",
FancyBed = "Fancy Bed",
FancyBlueRug = "Fancy Blue Rug",
FancyBlueRugCorner = "Fancy Blue Rug Corner",
FancyBrownRug = "Fancy Brown Rug",
FancyBrownRugCorner = "Fancy Brown Rug Corner",
FancyDarkDrawers = "Fancy Dark Drawers",
FancyDarkLargeTable = "Fancy Dark Large Table",
FancyDarkWardrobe = "Fancy Dark Wardrobe",
FancyGreenRug = "Fancy Green Rug",
FancyGreenRugCorner = "Fancy Green Rug Corner",
FancyGreyLightPost = "Fancy Grey Light Post",
FancyLargeTable = "Fancy Large Table",
FancyLightPost = "Fancy Light Post",
FancyLowTable = "Fancy Low Table",
FancyOakDrawers = "Fancy Oak Drawers",
FancyOakWardrobe = "Fancy Oak Wardrobe",
FancyOrangeRug = "Fancy Orange Rug",
FancyOrangeRugCorner = "Fancy Orange Rug Corner",
FancyOutdoorLamp = "Fancy Outdoor Lamp",
FancyOutdoorsBench = "Fancy Outdoors Bench",
FancyToilet = "Fancy Toilet",
FancyWhiteArmchair = "Fancy White Armchair",
FancyWhiteDrawers = "Fancy White Drawers",
FancyWhiteWardrobe = "Fancy White Wardrobe",
Fireplace = "Fireplace",
FireplaceDouble = "Double Fireplace",
FloodLights = "Flood Lights",
FloorBeigeCarpet = "Beige Carpet",
FloorBlackCarpet = "Black Carpet",
FloorBlueCarpet = "Blue Carpet",
FloorBordeauxCarpet = "Bordeaux Carpet",
FloorBrownCarpet = "Brown Carpet",
FloorDarkGreyCarpet = "Dark Grey Carpet",
FloorDarkRedCarpet = "Dark Red Carpet",
FloorGreenCarpet = "Green Carpet",
FloorGreenesGroceryCarpet = "Greenes Grocery Carpet",
FloorGreyCarpet = "Grey Carpet",
FloorGreyCurlyCarpet = "Grey Curly Carpet",
FloorLightGreenCarpet = "Light Green Carpet",
FloorPurpleCarpet = "Purple Carpet",
FloorRedCarpet = "Red Carpet",
FloorVioletCarpet = "Violet Carpet",
FloorWhiteCarpet = "White Carpet",
FloorYellowCarpet = "Yellow Carpet",
FoldingChair = "Folding Chair",
FossoilBlueWindowDoor = "Fossoil Blue Door with Window",
FossoilCounter = "Fossoil Counter",
FossoilCounterCorner = "Fossoil Counter Corner",
FossoilGarbageBin = "Fossoil Garbage Bin",
FryersClubIndustrial = "Fryers Club Industrial 2000",
Gas2GoCounter = "Gas2Go Counter",
Gas2GoCounterCorner = "Gas2Go Counter Corner",
Gas2GoRedWindowDoor = "Gas 2 Go Red Door with Window",
GenericCooledShelves = "Generic Cooled Shelves",
GenericShopCounter = "Generic Shop Counter",
GenericShopCounterCorner = "Generic Shop Counter Corner",
GlassDisplayCounter = "Glass Display Counter",
GlassDisplayCounterCorner = "Glass Display Counter",
GlassDisplayStand = "Glass Display Stand",
GravelCornerFloor = "Gravel Corner Floor",
GravelEdgeFloor = "Gravel Edge Floor",
GreenComfyArmchair = "Green Comfy Armchair",
GreenComfyCouch = "Green Comfy Couch",
GreenCounter = "Green Counter",
GreenCounterCorner = "Green Counter Corner",
GreenDinnerChair = "Green Dinner Chair",
GreenFridge = "Green Fridge",
GreenGarbageBin = "Green Garbage Bin",
GreenMilitaryCrate = "Green Military Crate",
GreenOven = "Green Oven",
GreyChair = "Grey Chair",
GreyFileCabinet = "Grey File Cabinet",
GreyGarbageBin = "Grey Garbage Bin",
GreyLazyArmchair = "Grey Lazy Armchair",
GreyLazyCouch = "Grey Lazy Couch",
GreyMilitaryCrate = "Grey Military Crate",
GreyOven = "Grey Oven",
GreySmoothTilesFloor = "Grey Smooth Tiles Floor",
GroceryDisplayCounter = "Grocery Display Counter",
GroceryTrapezoidCounter = "Grocery Trapezoid Counter",
HangingToilet = "Hanging Toilet",
HescoBarrier = "Hesco Barrier",
HospitalBed = "Hospital Bed",
IGUI_Builders_Sketchbook = "Builder's Sketchbook",
IGUI_Sketchbook_Category_Appliances_Bathroom = "Appliances Bathroom",
IGUI_Sketchbook_Category_Appliances_Cooking = "Appliances Cooking",
IGUI_Sketchbook_Category_Appliances_Fridges = "Appliances Fridges",
IGUI_Sketchbook_Category_Appliances_Laundry = "Appliances Laundry",
IGUI_Sketchbook_Category_Containers_Bookshelves = "Containers Bookshelves",
IGUI_Sketchbook_Category_Containers_Commercial = "Containers Commercial",
IGUI_Sketchbook_Category_Containers_Crates = "Containers Crates",
IGUI_Sketchbook_Category_Containers_Metal = "Containers Metal",
IGUI_Sketchbook_Category_Containers_Residential = "Containers Residential",
IGUI_Sketchbook_Category_Containers_Trashcans = "Containers Trashcans",
IGUI_Sketchbook_Category_Decorations_Garage = "Decorations Garage",
IGUI_Sketchbook_Category_Decorations_Outdoor = "Decorations Outdoor",
IGUI_Sketchbook_Category_Decorations_Roadway = "Decorations Roadway",
IGUI_Sketchbook_Category_Decorations_Rugs = "Decorations Rugs",
IGUI_Sketchbook_Category_Doors_Garage = "Doors Garage",
IGUI_Sketchbook_Category_Doors_Metal = "Doors Metal",
IGUI_Sketchbook_Category_Doors_Wooden = "Doors Wooden",
IGUI_Sketchbook_Category_Fences_High = "Fences High",
IGUI_Sketchbook_Category_Fences_Low = "Fences Low",
IGUI_Sketchbook_Category_Floors_Carpets = "Floors Carpets",
IGUI_Sketchbook_Category_Floors_Ceramic = "Floors Ceramic",
IGUI_Sketchbook_Category_Floors_Concrete = "Floors Concrete",
IGUI_Sketchbook_Category_Floors_Metal = "Floors Metal",
IGUI_Sketchbook_Category_Floors_Natural = "Floors Natural",
IGUI_Sketchbook_Category_Floors_Paved = "Floors Paved",
IGUI_Sketchbook_Category_Floors_Wooden = "Floors Wooden",
IGUI_Sketchbook_Category_Furniture_Beds = "Furniture Beds",
IGUI_Sketchbook_Category_Furniture_Dressers = "Furniture Dressers",
IGUI_Sketchbook_Category_Furniture_Seating = "Furniture Seating",
IGUI_Sketchbook_Category_Furniture_Tables = "Furniture Tables",
IGUI_Sketchbook_Category_Lighting = "Lighting",
IGUI_Sketchbook_Category_Masonry = "Masonry",
IGUI_Sketchbook_Category_Other = "Other",
IGUI_Sketchbook_Category_Stairs_Metal = "Stairs Metal",
IGUI_Sketchbook_Category_Stairs_Wood = "Stairs Wood",
IGUI_Sketchbook_Category_Welding = "Welding",
IGUI_Sketchbook_Category_Windows = "Windows",
IGUI_Sketchbook_Chapter = "Chapter %1: %2",
IGUI_Sketchbook_Chapter_Appliances = "Appliances",
IGUI_Sketchbook_Chapter_Containers = "Containers",
IGUI_Sketchbook_Chapter_Decorations = "Decorations",
IGUI_Sketchbook_Chapter_Doors = "Doors",
IGUI_Sketchbook_Chapter_Fences = "Fences",
IGUI_Sketchbook_Chapter_Floors = "Floors",
IGUI_Sketchbook_Chapter_Furniture = "Furniture",
IGUI_Sketchbook_Chapter_Lighting = "Lighting",
IGUI_Sketchbook_Chapter_Masonry = "Masonry",
IGUI_Sketchbook_Chapter_Other = "Other",
IGUI_Sketchbook_Chapter_Stairs = "Stairs",
IGUI_Sketchbook_Chapter_Welding = "Welding",
IGUI_Sketchbook_Chapter_Windows = "Windows",
IndustrialFridge = "Industrial Fridge",
IndustrialOven = "Industrial Oven",
IndustrialSink = "Industrial Sink",
ItemName_Base.ArchitecturalDigest_RugsCarpets = "Magazine: Architectural Digest - Rugs & Carpets",
ItemName_Base.AsphaltMixturePowder = "Bag of Asphalt Mixture Powder",
ItemName_Base.BucketAsphaltMixtureFull = "Bucket of Asphalt Mixture",
ItemName_Base.BuildersSketchbook = "Builder's Sketchbook",
ItemName_Base.DecorationsGuide_RoadwayGarage = "Magazine: Decoration Guide - Roadway & Garage",
ItemName_Base.FineWoodWorking_DoorsWindows = "Magazine: Fine Wood Working - Doors & Windows",
ItemName_Base.FineWoodWorking_Furniture_BedsCouchesArmchairs = "Magazine: Fine Wood Working - Beds Couches & Armchairs",
ItemName_Base.FineWoodWorking_Furniture_ChairsBenches = "Magazine: Fine Wood Working - Chairs & Benches",
ItemName_Base.FineWoodWorking_Furniture_Counters = "Magazine: Fine Wood Working - Counters",
ItemName_Base.FineWoodWorking_Furniture_Crates = "Magazine: Fine Wood Working - Crates",
ItemName_Base.FineWoodWorking_Furniture_DesksTables = "Magazine: Fine Wood Working - Desks & Tables",
ItemName_Base.FineWoodWorking_Furniture_Dressers = "Magazine: Fine Wood Working - Dressers",
ItemName_Base.FlooringGuide_Ceramic = "Magazine: Flooring Guide - Ceramic Tiles",
ItemName_Base.FlooringGuide_Paved = "Magazine: Flooring Guide - Paved Surfaces",
ItemName_Base.HomeMechanix_Bathroom = "Magazine: Home Mechanix - Bathroom Appliances",
ItemName_Base.InsulationFoam = "Insulation Foam",
ItemName_Base.OldHouseJournal_WoodenFloors = "Magazine: Old House Journal - Wooden Floors",
ItemName_Base.PlasticSheet = "Plastic Sheet",
ItemName_Base.PlasticSheetSmall = "Plastic Sheet Small",
ItemName_Base.PopularMechanics_HomeAppliances = "Magazine: Popular Mechanics - Home Appliances",
ItemName_Base.PopularMechanics_Lighting = "Magazine: Popular Mechanics - Lighting",
ItemName_Base.ProjectsInMetal_Diverse = "Magazine: Projects In Metal",
ItemName_Base.RefrigerantBottle = "Refrigerant Bottle",
ItemName_Base.RefrigeratorCompressor = "Refrigerator Compressor",
ItemName_Base.RubberSeal = "Rubber Seal",
ItemName_Base.SmallRubberTube = "Small Rubber Tube",
ItemName_Base.TheFamilyHandyman_StairsFences = "Magazine: The Family Handyman - Stairs & Fences",
ItemName_Base.ThinCopperPipe = "Thin Copper Pipe",
JorgeForeguyBarbecue = "Jorge Foreguy Barbecue",
LargeClothesRack = "Large Clothes Rack",
LargeDeluxeBath = "Large Deluxe Bath",
LargeFancyBed = "Large Fancy Bed",
LargeFridge = "Large Fridge",
LargeMetalShelves = "Large Metal Shelves",
LargeModernBed = "Large Modern Bed",
LargeOakBed = "Large Oak Bed",
LargeShopShelves = "Large Shop Shelves",
LargeWardrobe = "Large Wardrobe",
LeftBarBlackWallBar = "Left Bar Black Wall Bar",
LeftBarBrownWallBar = "Left Bar Brown Wall Bar",
LightAsphaltCornerFloor = "Light Asphalt Corner Floor",
LightAsphaltEdgeFloor = "Light Asphalt Edge Floor",
LightAsphaltFloor = "Light Asphalt Floor",
LightLowTable = "Light Low Table",
LightOakLargeTable = "Light Oak Large Table",
LightRoundLargeTable = "Light Round Large Table",
LightSwitchLeftSide = "Light Switch Left Side",
LightSwitchRightSide = "Light Switch Right Side",
LightWoodDrawers = "Light Wood Drawers",
LightWoodRestaurantLargeTable = "Light Wood Restaurant Large Table",
LightWoodWardrobe = "Light Wood Wardrobe",
LightwoodLargeDesk = "Lightwood Large Desk",
LongDarkLowTable = "Long Dark Low Table",
LongLightLowTable = "Long Light Low Table",
LongLowDoubleTable = "Long Low Double Table",
LongLowTable = "Long Low Table",
LowToilet = "Low Toilet",
LowWoodenGreyFence = "Low Wooden Grey Fence",
LowWoodenGreyFenceCorner = "Low Wooden Grey Fence Corner",
LowWoodenGreyFencePost = "Low Wooden Grey Fence Post",
LowWoodenRailing = "Low Wooden Railing",
LowWoodenRailingCorner = "Low Wooden Railing Corner",
LowWoodenRailingCornerTallPost = "Low Wooden Railing Corner with Tall Post",
LowWoodenRailingPost = "Low Wooden Railing Post",
LowWoodenRailingTallPost = "Low Wooden Railing Tall Post",
LowWoodenWhitePicketFence = "Low Wooden White Picket Fence",
LowWoodenWhitePicketFenceCorner = "Low Wooden White Picket Fence Corner",
LowWoodenWhitePicketFencePost = "Low Wooden White Picket Fence Post",
LowWoodenWhiteRailing = "Low Wooden White Railing",
LowWoodenWhiteRailingCorner = "Low Wooden White Railing Corner",
LowWoodenWhiteRailingCornerTallPost = "Low Wooden White Railing Corner with Tall Post",
LowWoodenWhiteRailingPost = "Low Wooden White Railing Post",
LowWoodenWhiteRailingTallPost = "Low Wooden White Railing Tall Post",
MailBox = "Mail Box",
MallGarbageBin = "Mall Garbage Bin",
MedicalMetalCounter = "Medical Metal Counter",
MediumAsphaltCornerFloor = "Medium Asphalt Corner Floor",
MediumAsphaltEdgeFloor = "Medium Asphalt Edge Floor",
MediumAsphaltFloor = "Medium Asphalt Floor",
MetalBrownRailroadFloor = "Metal Brown Railroad Floor",
MetalElevatorFloor1 = "Metal Elevator Floor",
MetalElevatorFloor2 = "Metal Elevator Floor",
MetalGreenIndustrialFloor = "Metal Green Industrial Floor",
MetalGreyIndustrialFloor = "Metal Grey Industrial Floor",
MetalGreyRailroadPanelFloor = "Metal Grey Railroad Panel Floor",
MetalRustyMeshFloor = "Metal Rusty Mesh Floor",
MetalRustyMeshGrateFloor = "Metal Rusty Mesh Grate Floor",
MetalSteelBarsFloor = "Metal Steel Bars Floor",
MilitaryLocker = "Military Locker",
MiniFridge = "Mini Fridge",
MirrorAndDrawers = "Mirror And Drawers",
ModernCounter = "Modern Counter",
ModernCounterCorner = "Modern Counter Corner",
ModernOutdoorLamp = "Modern Outdoor Lamp",
ModernOven = "Modern Oven",
ModernStairs = "Modern Stairs",
MotelCounter = "Motel Counter",
MotelCounterCorner = "Low Motel Counter Corner",
NeonOpenSign = "Neon Open Sign",
OakBarCounter = "Oak Bar Counter",
OakBarCounterCorner = "Oak Bar Counter Corner",
OakCounter = "Oak Counter",
OakCounterCorner = "Oak Counter Corner",
OakLargeTable = "Oak Large Table",
OakRoundLargeTable = "Oak Round Large Table",
OfficeLargeDesk = "Office Large Desk",
OldAsphaltCornerFloor = "Old Asphalt Corner Floor",
OldAsphaltEdgeFloor = "Old Asphalt Edge Floor",
OldAsphaltFloor = "Old Asphalt Floor",
OrangeDumpster = "Orange Dumpster",
OrangeModernArmchair = "Orange Modern Armchair",
OrangeModernCouch = "Orange Modern Couch",
OvalLightPost = "Oval Light Post",
OvalOutdoorLamp = "Oval Outdoor Lamp",
ParkBench = "Park Bench",
PileOCrepeBlueWindowDoor = "Pile O' Crepe Blue Door with Window",
PileOCrepeOrangeMetalDoor = "Pile O' Crepe Orange Metal Door",
PizzaWhirledBrownWindowDoor = "Pizza Whirled Brown Door with Window",
PizzaWhirledCounter = "Pizza Whirled Counter",
PizzaWhirledCounterCorner = "Pizza Whirled Counter Corner",
PizzaWhirledGreenMetalDoor = "Pizza Whirled Green Metal Door",
PizzaWhirledSeat = "Pizza Whirled Seat",
PlainFridge = "Plain Fridge",
PlasticLargeTable = "Plastic Large Table",
PlasticLowTable = "Plastic Low Table",
PopsicleFridge = "Popsicle Fridge",
PostBarrier = "Post Barrier",
PublicGarbageBin = "Public Garbage Bin",
PublicMailBox = "Public Mail Box",
PurpleRattanArmchair = "Purple Rattan Armchair",
PurpleRattanCouch = "Purple Rattan Couch",
Recipe_CeramicFloorRedCheckeredTiles = "Ceramic Floor Red Checkered Tiles",
Recipe_CeramicFloorWhiteBlackTiles = "Ceramic Floor White Black Tiles",
Recipe_DogHouse = "Dog House",
Recipe_DoubleWroughtIronGate = "Double Wrought Iron Gate",
Recipe_MakeBucketAsphaltMixture = "Mix Bucket of Asphalt Mixture",
Recipe_MakeBuildersSketchbook = "Make Builder's Sketchbook",
Recipe_MakeshiftTarget = "Makeshift Target",
Recipe_RedGlassDisplayStand = "Red Glass Display Stand",
Recipe_RedMobileToolCabinet = "Red Mobile Tool Cabinet",
Recipe_SpiffosDinnerChair = "Spiffos Dinner Chair",
Recipe_TurquoiseSmoothTilesFloor = "Turquoise Smooth Tiles Floor",
Recipe_WoodenStairRailing = "Wooden Stair Railing",
RecycleBin = "Recycle Bin",
RedFridge = "Red Fridge",
RedMetalDoor = "Red Metal Door",
RedModernArmchair = "Red Modern Armchair",
RedOven = "Red Oven",
RedWoodenChair = "Red Wooden Chair",
RightBarBlackWallBar = "Right Bar Black Wall Bar",
RightBarBrownWallBar = "Right Bar Brown Wall Bar",
RoadBlock = "Road Block",
RoadConeBig = "Road Cone Big",
RoadConeSmall = "Road Cone Small",
RoughWoodenDoor = "Rough Wooden Door",
RoundBin = "Round Bin",
RoundOutdoorLamp = "Round Outdoor Lamp",
RoundedGlassDisplayCounter = "Rounded Glass Display Counter",
Sandbox_BuildablesExpansion = "Buildables Expansion",
Sandbox_BuildablesExpansion_unlockingMethod_option1 = "Both: Learned or Sketched",
Sandbox_BuildablesExpansion_unlockingMethod_option2 = "Magazine Only",
Sandbox_BuildablesExpansion_unlockingMethod_option3 = "Sketchbook Only",
Sandbox_UnlockingMethod = "Buildables Unlocking Method",
Sandbox_UnlockingMethod_tooltip = "Controls how buildable recipes are learned and shown in the build menu. <BR> Choose between magazine reading, sketchbook drawing, or a combination of both.",
SeaHorseBrownWindowDoor = "Sea Horse Brown Door with Window",
SeahorseCoffeeCounter = "Seahorse Coffee Counter",
SeahorseCoffeeCounterCorner = "Seahorse Coffee Counter Corner",
SecurityDoor = "Security Door",
ShopDisplayCounter = "Shop Display Counter",
SimpleBed = "Simple Bed",
SimpleLargeTable = "Simple Large Table",
SimpleWoodenStairs = "Simple Wooden Stairs",
SinglePaneBlackDoor = "Single Pane Black Door",
SinglePaneChestnutDoor = "Single Pane Chestnut Door",
SliderWindow = "Slider Window",
SmallClothesRack = "Small Clothes Rack",
SmallTableWithDrawer = "Small Table With Drawer",
SmallWoodenCrate = "Small Wooden Crate",
SmoothLargeTable = "Smooth Large Table",
SmoothPlasticLargeTable = "Smooth Plastic Large Table",
SpiffoLoungeSeat = "Spiffo's Lounge Seat",
SpiffoOrangeWindowDoor = "Spiffo's Orange Door with Window",
SpiffoTypeALargeTable = "Spiffo's Type A Large Table",
SpiffoTypeBLargeTable = "Spiffo's Type B Large Table",
SpiffosBin = "Spiffo's Bin",
SpiffosCounter = "Spiffo's Counter",
SpiffosCounterCorner = "Spiffo's Counter Corner",
SpiffosRedMetalDoor = "Spiffo's Red Metal Door",
SquareTheaterCounter = "Square Theater Counter",
StandingVault = "Standing Vault",
Standpipe = "Standpipe",
SteelFridge = "Steel Fridge",
StretcherBed = "Stretcher Bed",
SturdyBench = "Sturdy Bench",
TallLightPost = "Tall Light Post",
TanDoor = "Tan Door",
TanMetalDoor = "Tan Metal Door",
TheaterCounter = "Theater Counter",
TheaterCounterCorner = "Theater Counter Corner",
TiledWindow = "Tiled Window",
Tooltip_SketchBook_AlreadySketched = "Already sketched in this Builder's Sketchbook",
Tooltip_SketchBook_CanSketch = "Can sketch",
Tooltip_SketchBook_CannotSketch = "Cannot sketch",
Tooltip_SketchBook_SketchStatus = "Sketch status:",
Tooltip_craft_armchairDesc = "A comfy armchair for when you're<br>too tired to keep running",
Tooltip_craft_barbecueDesc = "A barbecue for grilling flesh<br>because the undead aren't picky",
Tooltip_craft_bigWroughtFenceDesc = "A big iron fence to keep out the living<br>or the dead - doesn't really matter",
Tooltip_craft_bookshelvesDesc = "Shelves to store books... because knowledge<br>is still important - right?",
Tooltip_craft_cardboardCrateDesc = "A simple cardboard crate that might just<br>be as temporary as your survival",
Tooltip_craft_carpetFloorDesc = "Soft enough to muffle the screams<br>for a little while at least",
Tooltip_craft_chairsDesc = "Chairs for sitting... if you're<br>ever lucky enough to stop moving",
Tooltip_craft_commercialCounterDesc = "A wooden counter with storage for when<br>you're looting and maybe crafting",
Tooltip_craft_commercialCounterNoCraftDesc = "Sturdy counter for storage that won't<br>let you down like your last hope",
Tooltip_craft_concreteFloorDesc = "A surface as hard as your will to<br>survive. It'll outlast you",
Tooltip_craft_couchesDesc = "Couches for lounging... or for<br>hiding from the horde",
Tooltip_craft_dressersDesc = "Dressers for storing clothes you'll<br>never wear again",
Tooltip_craft_electricOvenDesc = "An oven to bake your last hopes...<br>assuming you have power",
Tooltip_craft_fireplaceDesc = "A fireplace for warmth... or just to watch<br>the world burn in comfort",
Tooltip_craft_floatingCounterDesc = "Wall-mounted counter to save space because<br>you're always running out of it",
Tooltip_craft_fridgeDesc = "Keep your food cold or store your<br>dreams of a better tomorrow",
Tooltip_craft_garageDecorationsDesc = "Decorative items for garages... for when<br>you're hiding in plain sight",
Tooltip_craft_lampDesc = "A lamp to shine light on your<br>inevitable doom",
Tooltip_craft_laundryMachinesDesc = "Machines for washing clothes...<br>if you're feeling optimistic",
Tooltip_craft_lightPostDesc = "A post-mounted light to attract more zombies.<br>What could go wrong?",
Tooltip_craft_lightSwitchDesc = "A switch to turn on the light...<br>if it's still working",
Tooltip_craft_metalClothesStandDesc = "A stand for hanging clothes... because running<br>from zombies is a fashion statement",
Tooltip_craft_metalContainerDesc = "A sturdy container for your valuables... if<br>you have any left",
Tooltip_craft_metalDoorDesc = "",
Tooltip_craft_metalLockerDesc = "A metal locker to keep your gear safe - or<br>just lock away your despair",
Tooltip_craft_microwaveOvenDesc = "A microwave for quick meals because who<br>has time for real cooking?",
Tooltip_craft_militaryCrateDesc = "A crate tough enough to hold your hopes and<br>dreams... or ammo or whichever",
Tooltip_craft_outdoorDecorationsDesc = "Decorations for your garden.",
Tooltip_craft_pavedFloorDesc = "For when you're tired of tripping<br>over the undead and want something sturdier",
Tooltip_craft_roadwayDecorationsDesc = "Decorations for roads and paths...<br>or just more ways to die",
Tooltip_craft_rugsDesc = "Rugs to add comfort or distract from<br>the stench of the apocalypse",
Tooltip_craft_showerDesc = "A shower for when you remember the last<br>time you felt clean",
Tooltip_craft_sinksDesc = "A sink to wash away the filth of<br>the world... if the water still works",
Tooltip_craft_toiletDesc = "Because even in the end times - you've<br>got to take care of business",
Tooltip_craft_trashCanDesc = "A container for trash... including all your<br>failed attempts at survival",
Tooltip_craft_vegetableBasketDesc = "A basket for fresh produce... assuming you<br>survive long enough to eat it",
Tooltip_craft_washingBinDesc = "A bin for storing clothes... maybe for when<br>you're too tired to wash them",
Tooltip_craft_windowsDesc = "Windows to watch the world burn...<br>from a safe distance",
Tooltip_craft_woodFloorDesc = "Because even the undead deserve a nice<br>wooden floor to shuffle across",
Tooltip_craft_woodenCrateDesc = "A basic wooden storage crate - perfect for<br>storing the things you'll never use",
Trailer1Window = "Trailer Window",
Trailer2Window = "Trailer Window",
TrailerCounter = "Trailer Counter",
TrailerFixedBench = "Trailer Fixed Bench",
TrailerFloatingCounter = "Trailer Floating Counter",
TrailerFridgeA = "Built-in Trailer Fridge 1",
TrailerFridgeB = "Built-in Trailer Fridge 2",
TrapezoidShopShelves = "Trapezoid Shop Shelves",
TwinBed = "Twin Bed",
UI_CraftCat_Appliances_Bathroom = "Appliances_Bathroom",
UI_CraftCat_Appliances_Cooking = "Appliances_Cooking",
UI_CraftCat_Appliances_Fridges = "Appliances_Fridges",
UI_CraftCat_Appliances_Laundry = "Appliances_Laundry",
UI_CraftCat_Carpentry = "Carpentry",
UI_CraftCat_Containers_Bookshelves = "Containers_Bookshelves",
UI_CraftCat_Containers_Commercial = "Containers_Commercial",
UI_CraftCat_Containers_Crates = "Containers_Crates",
UI_CraftCat_Containers_Metal = "Containers_Metal",
UI_CraftCat_Containers_Residential = "Containers_Residential",
UI_CraftCat_Containers_Trashcans = "Containers_Trashcans",
UI_CraftCat_Decorations_Garage = "Decorations_Garage",
UI_CraftCat_Decorations_Outdoor = "Decorations_Outdoor",
UI_CraftCat_Decorations_Roadway = "Decorations_Roadway",
UI_CraftCat_Decorations_Rugs = "Decorations_Rugs",
UI_CraftCat_Doors_Garage = "Doors_Garage",
UI_CraftCat_Doors_Metal = "Doors_Metal",
UI_CraftCat_Doors_Wooden = "Doors_Wooden",
UI_CraftCat_Fences_High = "Fences_High",
UI_CraftCat_Fences_Low = "Fences_Low",
UI_CraftCat_Floors_Carpets = "Floors_Carpets",
UI_CraftCat_Floors_Ceramic = "Floors_Ceramic",
UI_CraftCat_Floors_Concrete = "Floors_Concrete",
UI_CraftCat_Floors_Metal = "Floors_Metal",
UI_CraftCat_Floors_Natural = "Floors_Natural",
UI_CraftCat_Floors_Paved = "Floors_Paved",
UI_CraftCat_Floors_Wooden = "Floors_Wooden",
UI_CraftCat_Furniture_Beds = "Furniture_Beds",
UI_CraftCat_Furniture_Dressers = "Furniture_Dressers",
UI_CraftCat_Furniture_Seating = "Furniture_Seating",
UI_CraftCat_Furniture_Tables = "Furniture_Tables",
UI_CraftCat_Lighting = "Lighting",
UI_CraftCat_Masonry = "Masonry",
UI_CraftCat_Stairs_Metal = "Stairs_Metal",
UI_CraftCat_Stairs_Wood = "Stairs_Wood",
UI_CraftCat_Welding = "Welding",
UI_CraftCat_Windows = "Windows",
VegetableBasket = "Vegetable Basket",
VerdantGrassFloor = "Verdant Grass Floor",
Victorian1Armchair = "Victorian 1 Armchair",
Victorian1Couch = "Victorian 1 Couch",
Victorian2Armchair = "Victorian 2 Armchair",
Victorian2Couch = "Victorian 2 Couch",
Victorian3Armchair = "Victorian 3 Armchair",
Victorian3Couch = "Victorian 3 Couch",
Victorian4Armchair = "Victorian 4 Armchair",
Victorian4Couch = "Victorian 4 Couch",
Victorian5Armchair = "Victorian 5 Armchair",
Victorian5Couch = "Victorian 5 Couch",
Victorian6Armchair = "Victorian 6 Armchair",
Victorian6Couch = "Victorian 6 Couch",
WallBin = "Wall Bin",
WallVault = "Wall Vault",
WashingBin = "Washing Bin",
WheelieBin = "Wheelie Bin",
WhiteClothingDryer = "White Clothing Dryer",
WhiteCounter = "White Counter",
WhiteCounterCorner = "White Counter Corner",
WhiteDisplayCounter = "White Display Counter",
WhiteDoor = "White Door",
WhiteFancyShelves = "White Fancy Shelves",
WhiteFileCabinet = "White File Cabinet",
WhiteFridge = "White Fridge",
WhiteGlassSlidingDoor = "White Glass Sliding Door",
WhiteHangingSink = "White Hanging Sink",
WhiteIndustrialFridge = "White Industrial Fridge",
WhiteIndustrialWoodenStairs = "White Industrial Wooden Stairs",
WhiteLazyArmchair = "White Lazy Armchair",
WhiteLazyCouch = "White Lazy Couch",
WhiteMetalDoor = "White Metal Door",
WhiteMicrowave = "White Microwave",
WhiteModernArmchair = "White Modern Armchair",
WhiteMotelWoodenStairs = "White Motel Wooden Stairs",
WhitePanelDoor = "White Panel Door",
WhiteSink = "White Sink",
WhiteSmoothTilesFloor = "White Smooth Tiles Floor",
WhiteStandingSink = "White Standing Sink",
WhiteStrippedCounter = "White Stripped Counter",
WhiteStrippedCounterCorner = "White Stripped Counter Corner",
WhiteStrippedDisplayStand = "White Stripped Display Stand",
WhiteTiledWindow = "White Tiled Window",
WhiteWashingMachine = "White Washing Machine",
WhiteWindow = "White Window",
WhiteWindowDoor = "White Door with Window",
WhiteWindowMetalDoor = "White Metal Door with Window",
WhiteWoodenChair = "White Wooden Chair",
WiredHighFence = "Wired High Fence",
WiredHighFenceCorner = "Wired High Fence Corner",
WiredRazorHighFence = "Wired Razor High Fence",
WiredRazorHighFenceCorner = "Wired Razor High Fence Corner",
WoodFloorBirchwood = "Birchwood Floor",
WoodFloorChestnut = "Chestnut Wood Floor",
WoodFloorCinnamon = "Cinnamon Wood Floor",
WoodFloorFinewood = "Finewood Floor",
WoodFloorHardwood = "Hardwood Floor",
WoodFloorOakwood = "Oakwood Floor",
WoodFloorPinewood = "Pine Wood Floor",
WoodFloorWidePlank = "Wide Plank Floor",
WoodenChair = "Wooden Chair",
WoodenCounter = "Wooden Counter",
WoodenCounterCorner = "Wooden Counter Corner",
WoodenDecorativeHighFence = "Wooden Decorative High Fence",
WoodenDecorativeHighFencePost = "Wooden Decorative High Fence Post",
WoodenDoor = "Wooden Door",
WoodenHighFence = "Wooden High Fence",
WoodenHighFenceCorner = "Wooden High Fence Corner",
WoodenHighFencePost = "Wooden High Fence Post",
WroughtIronHighFence = "Wrought Iron High Fence",
WroughtIronHighFenceCorner = "Wrought Iron High Fence Corner",
WroughtIronHighFencePost = "Wrought Iron High Fence Post",
WroughtIronLowFence = "Wrought Iron Low Fence",
WroughtIronLowFenceCorner = "Wrought Iron Low Fence Corner",
WroughtIronLowFencePost = "Wrought Iron Low Fence Post",
YellowBrownWoodenStairs = "Yellow Brown Wooden Stairs",
YellowModernArmchair = "Yellow Modern Armchair",
YellowModernCouch = "Yellow Modern Couch",
YellowWallLocker = "Yellow Wall Locker",
ZippeeCounter = "Zippee Counter",
ZippeeCounterCorner = "Zippee Counter Corner",